ñ = 0241 Ñ = 0209

araña		Spinne
cerdo		Schwein
caballo		Pferd
mono		Affe
gato/gata	Katze
perro		Hund
pájaro		Vogel
pescado		Fisch
pato		Ente
oso		Bär
toro 		Stier
elefante	Elefant
pingüino	Pinguin
cangrejo 	Krebs
conejo		Kanninchen

naranja		Orange
cebolla		Zwiebel
jugo		Saft
manzana		Apfel
fresa		Erdbeere
comida		Essen
azúcar		Zucker
arroz		Reis
verduras	Gemüse
papa		Kartoffel
leche		Milch
agua		Wasser
tomate		Tomate
limón		Zitrone
pan		Brot
huevo		Ei
pollo		Hänchen
pasta		Nudeln
frueta		Obst
queso		Käse
galleta		Keks
emparedado	Sandwich
sopa		Suppe
carne		Fleisch
salsa		Soße
cerveza		Bier
té		Tee
sal		Salz

suéter		Pullover
ropa		Kleidung
abrigo		Mantel
cunturón	Gürtel
botas		Stiefel
zapato		Schuh
pantalón	Hose
sombrero	Hut
vestido		Kleid
falda		Rock
corbata		Krawatte
gafas		Brille
calcetine	Socke
traje		Anzug
camisa 		Hemd

desayuno	Frühstück
almuerzo	Mittagessen
cena		Abendessen


Cómo es España 		Wie ist Spanien
Quiénes son ellos	Wer sind sie?
Qué lees		Was liest du?
Cuál son sus zapatos?	Welche/-r/-s sind seine Schuhe?

Dónde		Wo
Cuándo		Wann
Cuánto		Wie viel


correr
corro - corres - corre - corremos - corréis - corren		renne
nadar
nado - nadas - nada - nadamos - nadáis - nadan			schwimme
pagar
pago - pagas - paga - pagamos -pagáis - pagan			bezahle
cocer
cocino - cocinas - cocina - cocinamos - cocináis - cocinan	kochen
caminar
camino - caminas - camina - caminamos - camináis - caminan 	laufen
limpiar
limpio - limpias - limpia - limpiamos - limpiáis - limpian	putzen

Unregelmäßige

hacer
hago - haces - hace - hacemos - hacéis - hacen			machen/tun
ir
voy - vas - va - vamos - vais - van				gehe
oír
oigo - oyes - oye - oímos - oigáis oigan			hören
poder
puedo - puedes - puede - podemos - podéis - pueden		kann
tener
tengo - tienes - tiene - tenemos - tenéis - tienen		haben
ver
veo - ves - ve - vemos- veis - ven				sehe
dormir
duermo - duermes - duerme - dormimos - dormis - duermen		schlafe

enero,  febrero, marzo, abril, mayo, junio, julio, agosto, septiembre, octubre, noviembre, diciembre
lunes, martes, miércoles, jueves, viernes, sábado, domingo
ayer, hoy, mañana
segundo, minuto, hora, dia, semana, mes, año

por qué 	warum
aunque		obwohl
mientras(que)	während (wohingegen)
pero		aber

Según Juan...	Laut Juan...
bajo 		unter
sobre		über
cerca 		in der Nähe
el libro es acerca... 	Im Buch geht es um.../Ist über
de 		von/aus/mit/als
en		in/im
al 		zum
a		zu
con 		mit
para 		für
hacia		nach
durante		während

tarde		spät
una vez		einmal
a veces 	manchmal
deste		von
hasta		bis
rato		(eine) weile/ in kürze

temporada	Jahreszeit/Zeitraum/Saison
estación	Jahreszeit/Bahnhof/Station
primavera	Frühling
verano		Sommer
otoño		Herbs
invierno	Winter

anoche 		gestern Abend
por la mañana	in der Früh
madrugada	Morgendämmerung
mediodia	Mittag[s|zeit]?
cita		Termin/Vereinbarung
fecha		Datum/Zeitpunkt
fiesta		Party/Feiertag
vacaciones	Ferien/Urlaub
compleaño	Geburtstag



cuchillo	Messer
mesa		Tisch
silla		Stuhl
cama		Bett
dormitorio	Schlafzimmer
vaso		Glas
cuchara		Löffel
plato		Teller
camino		Weg
cocina 		Küche
piscina 	Schwimmbecken
televisión	Fernsehen
cuna		Baby/Gitterbett
taza		Tassa
ventana		Fenster
teléfono	Telefon
puerta		Tür
escritorio	Schreibtisch
esponja		Schwamm
espejo		Spiegel
sartén 		Pfanne
sofá		Sofa
lámpara		Lampe
horno		Ofen
pared		Wand
piso		(Fuß)Boden
techo		Dach
sótano		Keller
escalera	Treppe/Leiter
mapa		Karte
baño		Toilette/Bad
cepillo		(Haar)Bürste
secadora	Trockner
lavadora	Waschmaschine
habitación	Raum/Zimmer
refrigerador	Kühlschrank
paraguas	Regenschirm
cartera		Brieftasche
sábana		Bettlaken
jabón		Seife
rasuradora	Rasierer


corto		kurz
largo		lang
alto		hoch
grande		groß/hoch
gran		groß/bedeutend
bajo		klein/geringe höhe
pequeño		klein
enorme		riesig/enorm
tamaño		Größe				tiene el tamaño de un huevo - Es ist so groß wie ein Ei(Es hat eine größe wie ein Ei)


rey/reina	König/Königin
principe	Prinz
sacerdote	Priester

doctor/a	Arzt/Ärztin
polocía		Polizist
secretario/a	Sekretär/in
juez		Richter
periodista	Journalist
abogado		Rechtsanwalt
pintor		Maler
granjeo		Farmer/Bauer
panadero	Bäcker
ingeniero	Ingenieur
carpintero	Tischler
cocinero	Koch
mesero		Kellner
conductor	Fahrer
cajero		Kassierer
enfermera	Krankenschwester

maestro		Lehrer
profesor(a)	Professor(in)
estudiante	Schüler

soldado		Soldat
comandante	Kommandant
guardia		Wächter
capitán		Kapitän
coronel		Oberst

jefe		Chef/Leiter
empresario	Unternehmer
dueño/duaña	Inhaber/in
empleado	Mitarbeiter/Angestellter

autor		Autor/Verfasser
poeta		Poet
artistas	Künstler
actor		Schauspieler
agente		Agent
atleta		Athlet

especialidad	Spezialität
especialisto	Fachmann 		especialisto en pájaros		Vogelspezialist	
trabajo		Arbeit/Beruf
profesíon	Beruf

duro		hart
buen		gut
necesario	notwendig
útiles		nützlich
último		letzte
imposible	unmöglich
simple		einfach
peor		schlimmer/schlechter
suficiente	genug/ausreichend
propia		eigene/s/r
siguiente	nächste/danach
profesional	professionell
claro		klar
pobre		arm/bedürftig
normal		normal/gewöhnlich
familiar	bekannt/vertraut
mala		schlecht/unzureichend
tantas		so viele
responsable	vernatwortlich/zuständig
justo		gerecht/knapp/genau
rica		reich
histórico	historisch
reciente	neu
plano		flach
natural		natürlich
próximo		nächster
juntos		gemeinsam
tradicional	traditionell
rápido		schnell
caro		teuer
barato		billig
pasado		vergangen
inteligente	intelligent
mejor		besser/lieber































